W W W W W W W W W W W W W W W W
W P B B B B B B B B B B B R B W
W R R R R R R R R R R R R R F W
W W W W W W W W W W W W W R B W
W D R B B B B B B B B B B R D W
W B R R R R R R R R R R R R B W
W B R W W W W W W W W W W W W W
W D R R R R R R R R R R R D C W
W W W W W W W W W W W W W W W W