W W W W W W W W W W W W W W W W
W C P W B B R R B W B R R R R W
W R R W R R D R R W R R D B R W
W R R W B R W R B W R R W R R W
W R B W R R W R R W R B W R R W
W R B W R B W B R W R R W R B W
W R R R R R W R R B B R W R B W
W R R D R B W B R D R R W R D W
W W W W W W W W W W W W W W W W